NO ./assets/textures/surfaces/gradient_dark_gray.png
SO ./assets/textures/surfaces/bricks_dark.png
EA ./assets/textures/surfaces/wood.png
WE ./assets/textures/surfaces/wood.png

F 30,30,30
C 40,40,40

111111
1Whhh1
1hh1h1
11hhh1
111111