NO ../textures/north_texture
SO ../textures/south_texture
WE ../textures/west_texture
EA ../textures/east_texture

F 20,20,20
C 100,100,250

111111111111111111        11111111111111111111111
110000000000000001        100a0b0c0d0010000000001
1100000000000000011111111110000000000010101010101
11000001111100000100mmmm00100000000000A0000000001
1e000000000000000100000000100000000000100000000011
1e000000000000000D00000000D0W000000000B000000000G1
1e000000000000000100000000100000000000100000000011
11000001111100000100000000100000000000C0000000001
1100000000000000011111111110000000000010101010101
110000000000000001        100a0b0c0d0010000000001
111111111111111111        11111111111111111111111