NO ./assets/textures/surfaces/bricks_dark.png
SO ./assets/textures/surfaces/bricks_dark.png
WE ./assets/textures/surfaces/bricks_dark.png
EA ./assets/textures/surfaces/bricks_dark.png

F 30,30,30
C 40,40,40

1111111111111
1eeeeeNeeeee1
1eeeeeeeeeee1
1eeeeeeeeeee1
1eeeeeeeeeee1
1eeeeeeeeeee1
1eeeeeeeeeee1
1eeeeeeeeeee1
1eeeeeeeeeee1
1eeeeeeeeeee1
1eeeeeeeeeee1
1eeeeeeeeeee1
1111111111111