NO ./assets/textures/surfaces/bricks_dark.png
SO ./assets/textures/surfaces/bricks_dark.png
WE ./assets/textures/surfaces/bricks_dark.png
EA ./assets/textures/surfaces/bricks_dark.png

F 30,30,30
C 40,40,40

1111111111111
100000s000001
1000000000001
1000000000001
1000000000001
1000000000001
1e0000W0000w1
1000000000001
1000000000001
1000000000001
1000000000001
100000n000001
1111111111111