NO ./assets/textures/surfaces/bricks_dark.png
SO ./assets/textures/surfaces/bricks_dark.png
WE ./assets/textures/surfaces/bricks_dark.png
EA ./assets/textures/surfaces/bricks_dark.png

F 30,30,30
C 40,40,40

111111111111111111111111111111111111111111111111111111111111111111111111111111111111111111111111111111111111111111111111111111111111111111111111111111111111111111111111111111111111111111111111111111111111
100000000000000D00000D000000000000000000000000D00000D000000000000000000000000D00000D000000000000000000000000D00000D000000000000000000000000D00000D000000000000000000000000D00000D000000000000000000000000D01
1010010100100000101001000000010100000000000000D00000D000000000000000000000000D00000D000000000000000000000000D00000D000000000000000000000000D00000D000000000000000000000000D00000D000000000000000000000000D01
100000000000000D00000D000000000000000000000000D00000D000000000000000000000000D00000D000000000000000000000000D00000D000000000000000000000000D00000D000000000000000000000000D00000D000000000000000000000000D01
1010010100100000101001000000010100000000000000D00000D000000000000000000000000D00000D000000000000000000000000D00000D000000000000000000000000D00000D000000000000000000000000D00000D000000000000000000000000D01
1010010010101010001001000000010100000000000000D00000D000000000000000000000000D00000D000000000000000000000000D00000D000000000000000000000000D00000D000000000000000000000000D00000D000000000000000000000000D01
100000000000000D00000D000000000000000000000000D00000D000000000000000000000000D00000D000000000000000000000000D00000D000000000000000000000000D00000D000000000000000000000000D00000D000000000000000000000000D01
1010010100100000101001000000010100000000000000D00000D000000000000000000000000D00000D000000000000000000000000D00000D000000000000000000000000D00000D000000000000000000000000D00000D000000000000000000000000D01
1010010010101010001001000000010100000000000000D00000D000000000000000000000000D00000D000000000000000000000000D00000D000000000000000000000000D00000D000000000000000000000000D00000D000000000000000000000000D01
100000000000000D00000D000000000000000000000000D00000D000000000000000000000000D00000D000000000000000000000000D00000D000000000000000000000000D00000D000000000000000000000000D00000D000000000000000000000000D01
1010010100100000101001000000010100000000000000D00000D000000000000000000000000D00000D000000000000000000000000D00000D000000000000000000000000D00000D000000000000000000000000D00000D000000000000000000000000D01
100000000000000D00000D000000000000000000000000D00000D000000000000000000000000D00000D000000000000000000000000D00000D000000000000000000000000D00000D000000000000000000000000D00000D000000000000000000000000D01
1010010100100000101001000000010100000000000000D00000D000000000000000000000000D00000D000000000000000000000000D00000D000000000000000000000000D00000D000000000000000000000000D00000D000000000000000000000000D01
1010010010101010001001000000010100000000000000D00000D000000000000000000000000D00000D000000000000000000000000D00000D000000000000000000000000D00000D000000000000000000000000D00000D000000000000000000000000D01
100000000000000D00000D000000000000000000000000D00000D000000000000000000000000D00000D000000000000000000000000D00000D000000000000000000000000D00000D000000000000000000000000D00000D000000000000000000000000D01
1010010100100000101001000000010100000000000000D00000D000000000000000000000000D00000D000000000000000000000000D00000D000000000000000000000000D00000D000000000000000000000000D00000D000000000000000000000000D01
1010010010101010001001000000010100000000000000D00000D000000000000000000000000D00000D000000000000000000000000D00000D000000000000000000000000D00000D000000000000000000000000D00000D000000000000000000000000D01
100000000000000D00000D000000000000000000000000D00000D000000000000000000000000D00000D000000000000000000000000D00000D000000000000000000000000D00000D000000000000000000000000D00000D000000000000000000000000D01
1010010100100000101001000000010100000000000000D00000D000000000000000000000000D00000D000000000000000000000000D00000D000000000000000000000000D00000D000000000000000000000000D00000D000000000000000000000000D01
1010010010101010001001000000010100000000000000D00000D000000000000000000000000D00000D000000000000000000000000D00000D000000000000000000000000D00000D000000000000000000000000D00000D000000000000000000000000D01
100000000000000D00000D000000000000000000000000D00000D000000000000000000000000D00000D000000000000000000000000D00000D000000000000000000000000D00000D000000000000000000000000D00000D000000000000000000000000D01
1010010100100000101001000000010100000000000000D00000D000000000000000000000000D00000D000000000000000000000000D00000D000000000000000000000000D00000D000000000000000000000000D00000D000000000000000000000000D01
1010010010101010001001000000010100000000000000D00000D000000000000000000000000D00000D000000000000000000000000D00000D000000000000000000000000D00000D000000000000000000000000D00000D000000000000000000000000D01
100000000000000D00000D000000000000000000000000D00000D000000000000000000000000D00000D000000000000000000000000D00000D000000000000000000000000D00000D000000000000000000000000D00000D000000000000000000000000D01
1010010100100000101001000000010100000000000000D00000D000000000000000000000000D00000D000000000000000000000000D00000D000000000000000000000000D00000D000000000000000000000000D00000D000000000000000000000000D01
1010010010101010001001000000010100000000000000D00000D000000000000000000000000D00000D000000000000000000000000D00000D000000000000000000000000D00000D000000000000000000000000D00000D000000000000000000000000D01
100000000000000D00000D000000000000000000000000D00000D000000000000000000000000D00000D000000000000000000000000D00000D000000000000000000000000D00000D000000000000000000000000D00000D000000000000000000000000D01
1010010100100000101001000000010100000000000000D00000D000000000000000000000000D00000D000000000000000000000000D00000D000000000000000000000000D00000D000000000000000000000000D00000D000000000000000000000000D01
1010010010101010001001000000010100000000000000D00000D000000000000000000000000D00000D000000000000000000000000D00000D000000000000000000000000D00000D000000000000000000000000D00000D000000000000000000000000D01
100000000000000D00000D000000000000000000000000D00000D000000000000000000000000D00000D000000000000000000000000D00000D000000000000000000000000D00000D000000000000000000000000D00000D000000000000000000000000D01
1010010100100000101001000000010100000000000000D00000D000000000000000000000000D00000D000000000000000000000000D00000D000000000000000000000000D00000D000000000000000000000000D00000D000000000000000000000000D01
1010010010101010001001000000010100000000000000D00000D000000000000000000000000D00000D000000000000000000000000D00000D000000000000000000000000D00000D000000000000000000000000D00000D000000000000000000000000D01
100000000000000D00000D000000000000000000000000D00000D000000000000000000000000D00000D000000000000000000000000D00000D000000000000000000000000D00000D000000000000000000000000D00000D000000000000000000000000D01
1010010100100000101001000000010100000000000000D00000D000000000000000000000000D00000D000000000000000000000000D00000D000000000000000000000000D00000D000000000000000000000000D00000D000000000000000000000000D01
1010010010101010001001000000010100000000000000D00000D000000000000000000000000D00000D000000000000000000000000D00000D000000000000000000000000D00000D000000000000000000000000D00000D000000000000000000000000D01
100000000000000D00000D000000000000000000000000D00000D000000000000000000000000D00000D000000000000000000000000D00000D000000000000000000000000D00000D000000000000000000000000D00000D000000000000000000000000D01
1010010100100000101001000000010100000000000000D00000D000000000000000000000000D00000D000000000000000000000000D00000D000000000000000000000000D00000D000000000000000000000000D00000D000000000000000000000000D01
1010010010101010001001000000010100000000000000D00000D000000000000000000000000D00000D000000000000000000000000D00000D000000000000000000000000D00000D000000000000000000000000D00000D000000000000000000000000D01
100000000000000D00000D000000000000000000000000D00000D000000000000000000000000D00000D000000000000000000000000D00000D000000000000000000000000D00000D000000000000000000000000D00000D000000000000000000000000D01
1010010100100000101001000000010100000000000000D00000D000000000000000000000000D00000D000000000000000000000000D00000D000000000000000000000000D00000D000000000000000000000000D00000D000000000000000000000000D01
1010010010101010001001000000010100000000000000D00000D000000000000000000000000D00000D000000000000000000000000D00000D000000000000000000000000D00000D000000000000000000000000D00000D000000000000000000000000D01
100000000000000D00000D000000000000000000000000D00000D000000000000000000000000D00000D000000000000000000000000D00000D000000000000000000000000D00000D000000000000000000000000D00000D000000000000000000000000D01
1010010100100000101001000000010100000000000000D00000D000000000000000000000000D00000D000000000000000000000000D00000D000000000000000000000000D00000D000000000000000000000000D00000D000000000000000000000000D01
1010010010101010001001000000010100000000000000D00000D000000000000000000000000D00000D000000000000000000000000D00000D000000000000000000000000D00000D000000000000000000000000D00000D000000000000000000000000D01
100000000000000D00000D000000000000000000000000D00000D000000000000000000000000D00000D000000000000000000000000D00000D000000000000000000000000D00000D000000000000000000000000D00000D000000000000000000000000D01
1010010100100000101001000000010100000000000000D00000D000000000000000000000000D00000D000000000000000000000000D00000D000000000000000000000000D00000D000000000000000000000000D00000D000000000000000000000000D01
1010010010101010001001000000010100000000000000D00000D000000000000000000000000D00000D000000000000000000000000D00000D000000000000000000000000D00000D000000000000000000000000D00000D000000000000000000000000D01
1010010010101010001001000000010100000000000000D00000D000000000000000000000000D00000D000000000000000000000000D00000D000000000000000000000000D00000D000000000000000000000000D00000D000000000000000000101000D01
1010010010101010001001000000010100000000000000D00000D000000000000000000000000D00000D000000000000000000000000D00000D000000000000000000000000D00000D000000000000000000000000D00000D0000000000000000010000N0D01
100000000D00D0000000000000000000D0000000000000D00000D000000000000000000000000D00000D000000000000000000000000D00000D000000000000000000000000D00000D000000000000000000000000D00000D000000000000000000000000D01
111111111111111111111111111111111111111111111111111111111111111111111111111111111111111111111111111111111111111111111111111111111111111111111111111111111111111111111111111111111111111111111111111111111111