NO ../textures/north_texture
SO ../textures/south_texture
WE ../textures/west_texture
EA ../textures/east_texture

F 30,30,30
C 40,40,40

1111111111111111111111111
1000000100000000000000001
1000000000000000000000001
1001000000111111111111001
1001111111100000100001001
1000011111100110001001001
1000001111100111111001001
1110000111100000001000001
1111000011100000001000001
1111100011111111001111111
1111100011111111001000001
1111100001111111000000001
1111100001111111000001001
1111110000011111111111001
1111111000000011111111001
1111111110000000000000001
11111111111100000000W0001
1111111111111111111111111