NO ../textures/north_texture
SO ../textures/south_texture
EA ../textures/east_texture
WE ../textures/west_texture

F 30,30,30
C 40,40,40

11111111    1111111111
10000001    1000S00001
10000001    1000000001
10000001111110000000011111
10000000000000000000000001
10000000000000000000000001
10000000000000000000000001
10000001111110000000000001
100000010000110000abc00001
10000001n000Ammm0000000001
10000001000011000000000001
10000001000010000000000001
10000001111110000100100001
10000000000000000000000001
10000000000000000000000001
10000000000000000000000001
1000000111111000011C100001
10000000000000000000000001
10000000000000000000000001
11111111111111111111111111