NO ../textures/north_texture
SO ../textures/south_texture
EA ../textures/east_texture
WE ../textures/west_texture

F 0,0,200
C 200,0,0

11111111    1111111111
10000001    1000S00001
10000001    1000000001
10000001111110000000011111
10000000000000000000000001
10000000000000000000000001
10000000000000000000000001
10000001111110000000000001
100000010000110000abc00001
100000010000Am000000000001
10000001000011000000000001
10000001n00010000000000001
10000001111110000100100001
10000000000000000000000001
10000000000000000000000001
10000000000000000000000001
1000000111111000011C100001
10000000000000000000000001
10000000000000000000000001
11111111111111111111111111