NO ./assets/textures/key_red_static.png
SO ./assets/textures/key_green_static.png
EA ./assets/textures/key_yellow_static.png
WE ./assets/textures/key_blue_static.png

F 0,0,200
C 200,0,0

11111111    1111111111
10000001    1000000001
1000000111  1000000001
10000001A11110000000011111
10000000000000000000000001
100000000000000000000000a1
10000001111110000000000001
100b0001eeee1000000wwww001
10000001eeeeA000000wwww001
10000001eeee10000000000001
10000001eeee10000000000001
1b000001111110000100100001
100b0000000100000000000001
1b000000W00100000000000001
1000d000000100000000000001
1000000111C11000011B100001
10000000000000000000000001
10000c00000000000000000001
11111111111111111111111111