NO ../textures/north_texture
SO ../textures/south_texture
EA ../textures/east_texture
WE ../textures/west_texture

F 0,0,200
C 200,0,0

11111111    1111111111
10000001    1000000001
10000001    1000000001
1000000111111000S000011111
1a000000000000000000000001
10000000000000000000000001
100000000000000000000000a1
10000001111110000000000001
10000001000010000000000001
100000010e00A0000000000001
10000001000010000000000001
10000001000010000000000001
10000001111110000100100001
10000000000100000000000001
1000000b000A00000000000001
10000000000100000000000001
1000000111C11000011B100001
10000000000000000000000001
10000000000000000000000001
11111111111111111111111111