NO ./assets/textures/surfaces/sludge_black.png
SO ./assets/textures/surfaces/sludge_green.png
EA ./assets/textures/surfaces/sludge_black.png
WE ./assets/textures/surfaces/sludge_black.png

F 30,30,30
C 40,40,40

11111111    1111111111
1000000111  1000000001
10000001G1  1000000001
10000001A11110000000011111
1000000000hh00000000000001
1000000000hh00000000000001
1000000111111000000mmm0001
10000001eeee1000000wwww001
10000001eeeeA000000wwwwcd1
10000001eeee10000000000001
10000001eeee10000000000001
1b000001111110000100100001
100b000mSmm100000000000001
1b000000000100000000000001
1000d000000100000000000001
1000000111C11000011B100001
10000a0000b00ccccc00000001
10000000000000000000000001
10000c00000000000000000001
11111111111111111111111111
