NO ../textures/north_texture
SO ../textures/south_texture
EA ../textures/east_texture
WE ../textures/west_texture

F 0,0,200
C 200,0,0

11111111    1111111111
10000001    1000000001
1000000111  1000000001
10000001G11110000000011111
10000000000000000000000001
10000000000000000000000001
10000001111110000000000001
10000001eeee1000000wwww001
10000001eeeeA000000wwww001
10000001eeee10000000000001
10000001eeee10000000000001
10000001111110000100100001
10000000000100000000000001
10000000S00100000000000001
10000000000100000000000001
1000000111C11000011B100001
10000a0000b00ccccc00000001
10000000000000000000000001
11111111111111111111111111
