NO ./assets/textures/surfaces/bricks_dark.pn
SO ./assets/textures/surfaces/bricks_dark.png
EA ./assets/textures/surfaces/bricks_dark.png
WE ./assets/textures/surfaces/bricks_dark.png

F 30,30,30
C 40,40,40

1111
1N01
10G1
1111