NO ../textures/north_texture
SO ../textures/south_texture
EA ../textures/east_texture
WE ../textures/west_texture

F 30,30,30
C 40,40,40

1111
1N0
10G1
1111