NO ../textures/north_texture
SO ../textures/south_texture
EA ../textures/east_texture
WE ../textures/west_texture

F 30,30,30
C 40,40,40

11111111    1111111111
10000001    1000000001
1000000111  1000000001
10000001A11110000000011111
10000000000000000000000001
10000000000000000000000001
10000001111110000000000001
10000001eeee1000000wwww001
10000001eeeeA000000wwww001
10000001eeee10000000000001
10000001eeee10000000000001
10000001111110000100100001
100b0000000100000000000001
10000000W00100000000000001
10000000000100000000000001
1000000111C11000011B100001
10000000000000000000000001
10000000000000000000000001
11111111111111111111111111