NO ./assets/textures/surfaces/sludge_black.png
SO ./assets/textures/surfaces/sludge_black.png
EA ./assets/textures/surfaces/sludge_black.png
WE ./assets/textures/surfaces/sludge_black.png

F 30,30,30
C 40,40,40

111111111111111111111
100000000000000000001
10000000000000000W001
100000000000000000001
111111111111111111111