NO ./assets/textures/surfaces/bricks_dark.png
SO ./assets/textures/surfaces/bricks_dark.png
WE ./assets/textures/surfaces/bricks_dark.png
EA ./assets/textures/surfaces/bricks_dark.png

F 30,50,30
C 36,106,115

11111111111111111111111111111111111111111111111111111111111111111111111111111111111111111
11111111111111111111100000000000000000001111111111111111111111111111111111111111111111111
1111111111111111111110b000000sbs000000b01111111111111111111111111111111111111111111111111
11111111111111111111100000000000000000001111111111111111111111111111111111111111111111111
11111111111111111111100000000000000000001111111111111111111111111111111111111111111111111
11111111111111111111100000000000000000001111111111111111111111111111111111111111111111111
11111111111111111111100000000000000000001111111111111111111111111111111111111111111111111
11111111111111111111100000000000000000001111111111111111111111111111111111111111111111111
11111111111111111111100000000000000000001111111111111111111111111111111111111111111111111
11111111111111111111100000000000000000001111111111111111111111111111111111111111111111111
11111111111111111111100000000000000000001111111111111111111111111111111111111111111111111
11111111111111111111100000000000000000001111111111111111111111111111111111111111111111111
11111111111111111111100000000000000000001111111111111111111111111111111111111111111111111
1111111111111111111110000000000000000000111111111111111111111DDDDDDDDDDDDDDDDDDDDDDDDDDD1
1111111111111111111110b000000000000000b0111111111111111111111DDDDDD111DDDDDDDDDDDDDDDDDD1
1111111111111111111110000000000000000000111111111111111111111DDDDDD1h1DDDDDDDDDDDDDDDDDD1
111111111111111111111111111111A111111111111111111111111111111DDDDDD1h1DDDDDDDDDDDDDDDDDD1
1000000000001000000011111111100011111111111111111111111111111DDDDDDDDDDDDDDDDDDDDDDDDDDD1
10000000000010c0000011111111100011111111111111111111111111111DDDDDDDDDDDDDDDDDDDDDDDDDDD1
1000000000001000000011111111100011111111111111111111111111111DDDDDDDDDDDDDDDDDDDDhhhhhDD1
1000111110001111100011111111100011111111111111111111111111111DDDDDDDDDDDDDDDDDDDDh111hDD1
1000100000000000100011111111100011111111111111111111111111111DDDDDDDDDDDDDDDDDDDDh111hDD1
100010000000000010001111111110001111111110m011111111111111111DDDDDDDDDDDDDDDDDDDDh111hDD1
1000100000000000100011111111100011111111100011111111111111111DDDDDDDDDDDDDDDDDDDDhhhhhDD1
1111100011111000100011111111100011111111100011111111111111111DDDDDDDDDDDDDDDDDDDDDDDDDDD1
10001000100010000000100000000000000000001000000000000000000w1DDDDDDDDDDDDDDDDDDDDDDDDDDD1
10001000100010000000B000000000E000000000D000000000000000000wDDDDDDDDDDDDDDDDDDDDDDDDDDDD1
10001000100010000000100000000000000000001000000000000000000w1DDDDDhhhhhDDDDDDDDDDDDDDDDD1
1000100010001111100011111111100011111111111111111111111111111DDDDDhhhhhDDDDDDDDDDDDDDDDD1
1000000010000000000011111111100011111111111111111111111111111DDDDDhhnhhDDDDDDDDDDDDDDDDD1
1000000010000000000011111111100011111111111111111111111111111DDDDDhhhhhDDDDDDDDDDDDDDDDD1
1000000010000000000011111111100011111111111111111111111111111DDDDDhhhhhDDDDDDDDDDDDDDDDD1
1000100011111111100011111111100011111111111111111111111111111DDDDDDDDDDDDDDDDDDDDDDDDDDD1
1000100000001000100011111111100011111111111111111111111111111DDDDDDDDDDDDDDDDDhhhhhDDDDD1
10001000000010c0100011111111100011111111111111111111111111111DhhhhhDDDDDDDDDDDh111hDDDDD1
1000100000001000100011111111100011111111111111111111111111111Dh111hDDDDDDDDDDDh1G1hDDDDD1
111h1111111111h111111111111111D111111111111111111111111111111Dh111hDDDDDDDDDDDh1D1hDDDDD1
111h1111111111h1111111111111100011111111111111111111111111111Dh111hDDDDDDDDDDDhhhhhDDDDD1
111hhhhhhhhhhhh1111111111111100011111111111111111111111111111DhhhhhDDDDDDDDDDDDDDDDDDDDD1
11111111111111111111111111111mam11111111111111111111111111111DDDDDDDDDDDDDDDDDDDDDDDDDDD1
11111111111111111111111111111111111111111111111111111111111111111111111111111111111111111