NO ./assets/textures/surfaces/bricks_dark.png
SO ./assets/textures/surfaces/bricks_dark.png
WE ./assets/textures/surfaces/bricks_dark.png
EA ./assets/textures/surfaces/bricks_dark.png

F 30,30,50
C 36,106,115

11111111111111111111111111111111111111111111111111111111111111111111111111111
11111111111111111111100000000000000000001111111111111111111111111111111111111
1111111111111111111110b000000wbw000000b01111111111111111111111111111111111111
11111111111111111111100000000000000000001111111111111111111111111111111111111
11111111111111111111100000000000000000001111111111111111111111111111111111111
11111111111111111111100000000000000000001111111111111111111111111111111111111
11111111111111111111100000000000000000001111111111111111111111111111111111111
11111111111111111111100000000000000000001111111111111111111111111111111111111
11111111111111111111100000000000000000001111111111111111111111111111111111111
11111111111111111111100000000000000000001111111111111111111111111111111111111
11111111111111111111100000000000000000001111111111111111111111111111111111111
11111111111111111111100000000000000000001111111111111111111111111111111111111
11111111111111111111100000000000000000001111111111111111111111111111111111111
11111111111111111111100000000000000000001111111111111111111111111111111111111
1111111111111111111110b000000000000000b01111111111111111111111111111111111111
11111111111111111111100000000000000000001111111111111111111111111111111111111
111111111111111111111111111111A1111111111111111111111111111111111111111111111
10000000000010000000111111111000111111111111111111111111111111111111111111111
10000000000010c0000011111111100011111111111111111111111111111DDDDDDDDDDDDDD11
1000000000001000000011111111100011111111111111111111111111111DDDDDDDDDDDDDD11
1000111110001111100011111111100011111111111111111111111111111DDDDDDDDDhhhDD11
1000100000000000100011111111100011111111111111111111111111111DDDDDDDDDhhhDD11
10001000000000001000111111111000111111111mmm11111111111111111DDDDDDDDDhhhDD11
1000100000000000100011111111100011111111100011111111111111111DDDDDDDDDDDDDD11
1111100011111000100011111111100011111111100011111111111111111DDDDDDDDDDDDDD11
10001000100010000000100000000000000000001000000000000000000n1DDDDDDDDDDDDDD11
10001000100010000000B000000000E000000000D000000000000000000nDDDDDDDDDDDDDDD11
10001000100010000000100000000000000000001000000000000000000n1DDDDDDDDDDDDDD11
1000100010001111100011111111100011111111111111111111111111111DDDDDDDDDDDDDD11
1000000010000000000011111111100011111111111111111111111111111DDDDDDDDDDDDDD11
1000000010000000000011111111100011111111111111111111111111111DDDDDDDD000DDD11
1000000010000000000011111111100011111111111111111111111111111DDDDDDDD0G0DDD11
1000100011111111100011111111100011111111111111111111111111111DDDDDDDD000DDD11
1000100000001000100011111111100011111111111111111111111111111DDDDDDDDDDDDDD11
10001000000010c0100011111111100011111111111111111111111111111DDDDDDDDDDDDDD11
10001000000010001000111111111000111111111111111111111111111111111111111111111
111h1111111111h111111111111111D1111111111111111111111111111111111111111111111
111h1111111111h11111111111111000111111111111111111111111111111111111111111111
111hhhhhhhhhhhh11111111111111000111111111111111111111111111111111111111111111
11111111111111111111111111111mam111111111111111111111111111111111111111111111
11111111111111111111111111111111111111111111111111111111111111111111111111111