NO ./assets/textures/surfaces/bricks_Dark.png
SO ./assets/textures/surfaces/bricks_Dark.png
WE ./assets/textures/surfaces/bricks_Dark.png
EA ./assets/textures/surfaces/bricks_Dark.png

F 30,50,30
C 36,106,115

11111111111111111111111111111111111111111111111111111111111111111111111111111111111111111
11111111111111111111100000000000000000001111111111111111111111111111111111111111111111111
1111111111111111111110b000000sbs000000b01111111111111111111111111111111111111111111111111
11111111111111111111100000000000000000001111111111111111111111111111111111111111111111111
11111111111111111111100000000000000000001111111111111111111111111111111111111111111111111
11111111111111111111100000000000000000001111111111111111111111111111111111111111111111111
11111111111111111111100000000000000000001111111111111111111111111111111111111111111111111
11111111111111111111100000000000000000001111111111111111111111111111111111111111111111111
11111111111111111111100000000000000000001111111111111111111111111111111111111111111111111
11111111111111111111100000000000000000001111111111111111111111111111111111111111111111111
11111111111111111111100000000000000000001111111111111111111111111111111111111111111111111
11111111111111111111100000000000000000001111111111111111111111111111111111111111111111111
11111111111111111111100000000000000000001111111111111111111111111111111111111111111111111
1111111111111111111110000000000000000000111111111111111111111OOOOOhhhhhOOOOOOOOOOOOOOOOO1
1111111111111111111110b000000000000000b0111111111111111111111OOOOOh111hOOOOOOOOOOOOOOOOO1
1111111111111111111110000000000000000000111111111111111111111OOOOOh1d1hOOOOOOOOOOOOOOOOO1
111111111111111111111111111111A111111111111111111111111111111OOOOOh1A1hOOOOOOOOOOOOOOOOO1
1000000000001000000011111111100011111111111111111111111111111OOOOOhhhhhOOOOOOOOOOOOOOOOO1
10000000000010c0000011111111100011111111111111111111111111111OOOOOOOOOOOOOOOOOOOOOOOOOOO1
1000000000001000000011111111100011111111111111111111111111111OOOOOOOOOOOOOOOOOOOOhhhhhOO1
1000111110001111100011111111100011111111111111111111111111111OOOOOOOOOOOOOOOOOOOOh111hOO1
1000100000000000100011111111100011111111111111111111111111111OOOOOOOOOOOOOOOOOOOOh111hOO1
100010000000000010001111111110001111111110m011111111111111111OOOOOOOOOOOOOOOOOOOOh111hOO1
1000100000000000100011111111100011111111100011111111111111111OOOOOOOOOOOOOOOOOOOOhhhhhOO1
1111100011111000100011111111100011111111100011111111111111111OOOOOOOOOOOOOOOOOOOOOOOOOOO1
10001000100010000000100000000000000000001000000000000000000w1OOOOOOOOOOOOOOOOOOOOOOOOOOO1
10001000100010000000B000000000E000000000O000000000000000000wOOOOOOOOOOOOOOOOOOOOOOOOOOOO1
10001000100010000000100000000000000000001000000000000000000w1OOOOOhhhhhOOOOOOOOOOOOOOOOO1
1000100010001111100011111111100011111111111111111111111111111OOOOOhhhhhOOOOOOOOOOOOOOOOO1
1000000010000000000011111111100011111111111111111111111111111OOOOOhhnhhOOOOOOOOOOOOOOOOO1
1000000010000000000011111111100011111111111111111111111111111OOOOOhhhhhOOOOOOOOOOOOOOOOO1
1000000010000000000011111111100011111111111111111111111111111OOOOOhhhhhOOOOOOOOOOOOOOOOO1
1000100011111111100011111111100011111111111111111111111111111OOOOOOOOOOOOOOOOOOOOOOOOOOO1
1000100000001000100011111111100011111111111111111111111111111OOOOOOOOOOOOOOOOOhhhhhOOOOO1
10001000000010c0100011111111100011111111111111111111111111111OhhhhhOOOOOOOOOOOh111hOOOOO1
1000100000001000100011111111100011111111111111111111111111111Oh111hOOOOOOOOOOOh1G1hOOOOO1
111h1111111111h111111111111111O111111111111111111111111111111Oh111hOOOOOOOOOOOh1D1hOOOOO1
111h1111111111h1111111111111100011111111111111111111111111111Oh111hOOOOOOOOOOOhhhhhOOOOO1
111hhhhhhhhhhhh1111111111111100011111111111111111111111111111OhhhhhOOOOOOOOOOOOOOOOOOOOO1
11111111111111111111111111111mam11111111111111111111111111111OOOOOOOOOOOOOOOOOOOOOOOOOOO1
11111111111111111111111111111111111111111111111111111111111111111111111111111111111111111