NO ./assets/textures/surfaces/sludge_black.png
SO ./assets/textures/surfaces/sludge_black.png
EA ./assets/textures/surfaces/sludge_black.png
WE ./assets/textures/surfaces/sludge_black.png

F 30,30,30
C 40,40,40

111111111111111111111111111111111111111111111111111111111111111111111
10000000000000000000h000000010000000o000000000000000000000000000o0001
10000000000000000000h000000010000000o000000000000000000000000000o0b01
10000000000000000000h000000010000000o000000000000000000000000000o0001
100011111111111111111ooo100010001000100011111111111111111111100011111
100000001000000000001000100000001000100000000000o000h0000000100000001
100000001000000000001000100000001000100000000000o000h0000000100000001
100000001000000000001000100000001000100000000000o000h0000000100000001
100010001000111110001000111111111000111111111111100010001111111110001
100000001000000010000000o0000000100000001000o000h00010001000000000001
100000001000000010000000o000000010000000B000o000h00010001000000000001
100000001000000010000000o0000000100000001000o000h00010001000000000001
10001000111110001111111110001000111111111hhh11A1111110001000111111111
1000000000001000000000001000100000000000100000001hhh10001000o00000001
100000000000100000000000100010000000000010G00000Dhhh10001000o00000001
1000000000001000000000001000100000000000100000001hhh10001000o00000001
1000100010001000111110001000111110001111111111111hhh10001000111110001
10000000000010001hhhh000h00000001000000000000000h000o0000000000010001
10000000000010001hdhh000h000000010000000000000w0h000o0000000000010001
10000000000010001hhhh000h00000001000000000000000h000o0000000000010001
100010001000100011111111111111111000111111111111111111111111100010001
1000100000000000000000001000000010001000000000000000hhhhh000000010001
100010000000000000000000C000000010001000000000000000hjhhh000000010001
1000100000000000000000001000000010001000000000000000hhhhh000000010001
1hhh10001111111111111111111110001000100011111111111111111111111110001
1hhh100000000000h000o000111110001000100000000000100000000000000000001
1hhh100000000000h0a0o000111110001000100000000000100000000000000000001
1hhh100000000000h000o000111110001000100000000000100000000000000000001
111111111111111111111000111110001000100011111000100011111000111111111
100010000000000000000000100000001000100000001000100010000000100000001
10a010000000000000000000100000001000100000001000100010000000100000001
100010000000000000000000100000001000100000001000100010000000100000001
1000100011111111100011111000111110001111100011111000100011111hhh10001
100010000000h00010000000000000000000000000000000000010000000o00010001
1000100000m0h000100000000000000000N0000000000000000010000000o0a010001
100010000000h00010000000000000000000000000000000000010000000o00010001
100011111111100011111111100011111000111111111000111111111111111110001
100000000000000010001000000000001000100000001000000000000000000000001
100000000000000010001000000000001000100000001000000000000000000000001
100000000000000010001000000000001000100000001000000000000000000000001
100011111111111110001000111111111000100010001111111111111111100010001
10001000000000001000100011111000000000001000h000100010000000000010001
10001000000000001000100011111000000000001000h000B00010m00000000010001
10001000000000001000100011111000000000001000h000100010000000000010001
100010001111100010001000111110001111100011111000100011111111111110001
100000001000000010000000100010001000000000001000100000000000100000001
1000000010000000100000001000100010000000000010c0100000000000100000001
100000001000000010000000100010001000000000001000100000000000100000001
111110001000111111111000100011111000111110001111111111111000100011111
1000100010000000000000001000000000001000100000000000o000000010001hhh1
10b01000100000000000000010000000000010m0100000000000o000000010001hhh1
1000100010000000000000001000000000001000100000000000o000000010001hkh1
1hhh10001000111111111000111111111hhh10001111111111111000111110001hhh1
100000001000000000001000000010001000o000100000000000o0000000000010001
100000001000000000001000000010b0A000o000100000000000o0000000000010001
100000001000000000001000000010001000o000100000000000o0000000000010001
1111111111111111100011111000111111111000100011111000111111111hhh10001
1000hhhh1000000000001111100000000000000010001111100010000000100000001
1000hhjh1000000000001111100000000000000010001111100010000000100000001
1000hhhh1000000000001111100000000000000010001111100010000000100000001
100011111ooo111111111111100011111000100010001111111110001000100010001
100010000000000000000000100010000000100000000000000000001000o00010001
100010000000000000000000100010000000100000000000000000001000o00010001
100010000000000000000000100010000000100000000000000000001000o00010001
10001000111111111hhh111110001000111111111111111111111111111110001hhh1
100000001000000000000000000010000000000000000000h000o000000000001hih1
100000001000000000000000000010000000000000000000h0b0o000000000001hhh1
100000001000000000000000000010000000000000000000h000o000000000001hhh1
111111111111111111111111111111111111111111111111111111111111111111111