NO ../textures/north_texture
SO ../textures/south_texture
WE ../textures/west_texture
EA ../textures/east_texture

F 220,100,0
C 225,30,0

111111111111111111        111  1111111
1           1    1		  1      1   1
11111    1111    1111     11111111   1
1   1    1    1     1111111          1
1  1111  111111           1    1111111
1  1  1           111111111    1
1111     1111111111            111
         1001                  1N1
    111111111                  111