NO ../textures/north_texture
SO ../textures/south_texture
EA ../textures/east_texture
WE ../textures/west_texture

F 0,0,200
C 200,0,0

111111111111111111111111111111111111111111111111111111
100000000000000000000000000000000000000000000000000001
101110000000000000000000000000000000000000000000000001
100010000000000000000000000000000000000000000000000001
101110000000000000000000000000000000000000000000000001
101G00000000000000000000000000000000000000000000000001
101110000000000000000000000000000000000000000000000001
100000000000000000000000000000000000000000000000000001
100000000000000000000000000000000000000000000000000001
100000000000000000000000000000000000000000000000000001
10E0000000000000000a0000000000abcd00000000000000000001
1000000000000000000b0000000000000000000000000000000001
1000000000000000000c0000000000000000000000000000000001
1000000000000000000d0000000000000000000000000000000001
100000000000000000000000000000000000000000000000000001
100000000000000000000000000000000000000000000000000001
100000000000000000000000000000000000000000000000000001
100000000000000000000000000000000000000000000000000001
100000000000000000000000000000000000000000000000000001
100000000000000000000000000000000000000000000000000001
100000000000000000000000000000000000000000000000000001
111111111111111111111111111111111111111111111111111111