NO ./assets/textures/surfaces/sludge_black.png
SO ./assets/textures/surfaces/sludge_green.png
EA ./assets/textures/surfaces/sludge_black.png
WE ./assets/textures/surfaces/sludge_black.png

F 30,30,30
C 40,40,40

11111111111111111111111111111111111111111111111111111111111111111111111111111
11111111111111111111111111111111111111111111111101111000000011011111111111111
111111111111000001000011001111111111111111111111011000b0000000011111111111111
11111111111000000000000000001111111111111111111100000000010011111111111111111
1111111110000000000000000000GDhAhhh111111111111111000001100111111111111111111
1111111100000000000000000000111111h1110001111111000000011h1111111111111111111
1111111110000000111110001111111111h1111101111111000001011h1111111111111111111
1110111000000001111111111111111111h1110000100111000011111h1111111111111111111
1100000000000011111111111111111111h1110b00000110000001111h1111111111111111111
1101100000011111111111111111111111h1110000000000000000011h1111111111111111111
1110000000111111111111111111111111h1101000000000000001011h1111111111111111111
1000000010011111111111111111111111h1100011100000000001111h1111111111111111111
1110000011111111111111111111111111h11111111101110000011hhh1111111111111111111
1110000000000111111111111111111111h111111111111111A1111h111111111111111111111
1110000000000101111110001101111111h11111111111100000011h111111111111111111111
1111011000000001111111100000111111h11111101110000000011h111111111111111111111
111111000000000000100000a0000111110010011000110000000010000111100001111000111
111111001000000000C0000000000001101000001100000000000011101000000010000011111
11111000100000000010000000000001100110011000000000000000000000000000000001011
11111111110000011111110000000000000100000000000000000000000000000000a00011011
11111111111111111111111101000000000001000000000000000000000000000000000000011
11111111111hhhhhh111111001111000000000000000000000110111000010000000000011111
1111111111111111h111011111111100000000000000000101111110011111111000000111111
11111111100100hhh111001111110000000000000000000001100011111111111111110111111
111100000000011111100000011000100000000000000000000011011111111hhhhhhh0111111
111101000000000010000000000000000000000000000000000000001111111h1111111111111
1111110000000000B0000000000000000000000000000000000000w00111111h1111111111111
111100000000000010000000000000000000000000000000000000000111111h1111111111111
1111100000000001110110010001000000000000000000000000000001111111hh001111111111
11000000000001111111001111000000000000000000000100101111110111111100011111111
11000000001011111111111111111000000000000000000011111111110111000000111111111
101000000001011hhhhhhhhhhhhh1101100000000001000000001111110000000c00011111111
100000000000001hhhh11111111h0001110000000001100000011111111100000000001111111
111000000011101hhhh1111111111000111110001111001000001011111000000000111111111
1000000000111hhhhhhh111111111111111110001111100000000001000000000000111111111
1100000000001111111h111111111111111110001111111000000000000000000010001111111
10000000000011111111111111111111111110001111111100000000000000011111101111111
1100c000000111111111111111111111111110001hhh111110000000000001101111111111111
11000000100011111111111111111111111110001hdhhhhh11100100001100001111111111111
11110000011111111111111111111111111110001hhh111hh0000011101101111111111111111
11111101111111111111111111111111111110001111111111111111111111111111111111111
11110001111111111111111111111111111110001111111111111111111111111111111111111
11111111111111111111111111111111111110N01111111111111111111111111111111111111
11111111111111111111111111111111111111111111111111111111111111111111111111111
11111111111111111111111111111111111111111111111111111111111111111111111111111
