NO ./assets/textures/surfaces/sludge_black.png
SO ./assets/textures/surfaces/sludge_green.png
EA ./assets/textures/surfaces/sludge_black.png
WE ./assets/textures/surfaces/sludge_black.png

F 30,30,30
C 40,40,40

11111111111111111111111111111111111111111111111111111111111111111111111111111
11111111111111111111111111111111111111111111111111111111111111111111111111111
11111111111111111111111111111111111111111111111111111111111111111111111111111
100000000000000000000000000010000000h000000000000000000000001000h000000011111
10E000000000000000000000000010000000h000000000000000000000001000h000000011111
100000000000000000000000000010000000h000000000000000000000001000h000000011111
11111111111110001111111110001000111111111000111111111111100010001111100011111
111110000000000000001000h0000000000000001000000000001000000010000000100011111
111110000000000000001000h0000000000000001000000000001000000010000000100011111
111110000000000000001000h0000000000000001000000000001000000010000000100011111
111110001111111110001000111111111111100011111000100010001111111110001ooo11111
11111000000010000000100000001000o00000001000000010001000000000000000100011111
11111000000010000000100000001000o00000001000000010001000000000000000100011111
11111000000010000000100000001000o00000001000000010001000000000000000100011111
111111111ooo10001111111110001000111111111000100010001111111111111000100011111
11111000h000100010000000o0001000100000000000100010000000100000000000000011111
11111000h000100010000000o0001000100000000000100010000000100000000000000011111
11111000h000100010000000o0001000100000000000100010000000100000000000000011111
11111ooo1000100011111111111110001000111111111000111111111ooo11111111111111111
111110001000100000000000o0000000000000000000100000000000o00010000000000011111
111110001000100000000000o0000000000000000000100000000000o00010000000000011111
111110001000100000000000o0000000000000000000100000000000o00010000000000011111
111110001hhh10001111111110001111111111111ooo111111111111100010001111100011111
11111000000000001000000000000000000010000000000000000000000010001000000011111
11111000000000001000000000000000000010000000000000000000000010001000000011111
11111000000000001000000000000000000010000000000000000000000010001000000011111
11111111111110001000111111111111100010001111111111111000111111111000111111111
11111000000000001000000000001000000010001000000000001000000000000000000011111
11111000000000001000000000001000000010001000000000001000000000000000000011111
11111000000000001000000000001000000010001000000000001000000000000000000011111
1111111111111111111110001000111111111hhh100011111ooo1000111111111111100011111
1hhhh000100000000000000010000000100000001000000010000000000000000000100011111
1hhhh000100000000000000010000000100000001000000010000000000000000000100011111
1hhhh000100000000000000010000000100000001000000010000000000000000000100011111
1hhh10001ooo11111111111111111000100011111111100010001111111111111ooo100011111
1hhh1000000000000000h0000000h000100000000000000010001000000000001000h00011111
1hhh1000000000000000h0000000h000100000000000000010001000000000001000h00011111
1hhh1000000000000000h0000000h000100000000000000010001000000000001000h00011111
1hhh11111111111110001ooo1ooo1111111111111111100010001111111110001000111111111
1hhhh000000010001000o000h00000000000000000001000100000001000000010000000hhhh1
1hhhh000000010001000o000h00000000000000000001000100000001000000010000000hhhh1
1hhhh000000010001000o000h00000000000000000001000100000001000000010000000hhhh1
1111111110001000111110001000111111111111111110001111111110001111111111111hhh1
1111100010001000000000001000100000000000000000000000000000000000100000001hhh1
1111100010001000000000001000100000000000000000000000000000000000100000001hhh1
1111100010001000000000001000100000000000000000000000000000000000100000001hhh1
1111100010001111111110001000100011111111100011111111100011111000111110001hhh1
1111100010000000000010001000000010000000100000000000100010001000000000001hhh1
1111100010000000000010001000000010000000100000000000100010001000000000001hhh1
1111100010000000000010001000000010000000100000000000100010001000000000001hhh1
1111100011111111100010001111111111111000111111111111100010001000111111111hhh1
111110000000000000000000000000000000100000000000000000000000100000000000o0001
111110000000000000000000000000000000100000000000000000000000100000000000o0G01
111110000000000000000000000000000000100000000000000000000000100000000000o0001
11111111111111111111111111111111111111111111111111111111111111111111111111111
11111111111111111111111111111111111111111111111111111111111111111111111111111
11111111111111111111111111111111111111111111111111111111111111111111111111111