NO ./assets/textures/surfaces/sludge_black.png
SO ./assets/textures/surfaces/sludge_black.png
EA ./assets/textures/surfaces/sludge_black.png
WE ./assets/textures/surfaces/sludge_black.png

F 30,30,30
C 40,40,40

1111111111111111111111111111111111111111111111111111111111111111111111111111111111111111111111111111111111111111111111111111111111111
10000000000000000000000000000000000000000000100000000000000000w0000000000000000000000000100000000000000000000000000000000000000000001
1000000000000000000000000w00000000000000000010000000000000000000000000000000000000000000000000000000000000000000000000000000000000001
10E0000000000000000000000000000000000000000010000000000000000000000000000000000000w00000000000000000000000000000000000000000000000001
1000000000000000000000000000000000000000000000000000000000000000000000000000000000000000000000000000000000000000000000000000000000001
100000000000000000000000000000000000w0000000000000000000000000w0000000000000000000000000100000000000000000000000000000000000000000001
1111111111111111111111111111111111111111111111111111111111111111111111111111111111111111111111111111111111111111111111111111111111111
