NO ../textures/north_texture
SO ../textures/south_texture
EA ../textures/east_texture
WE ../textures/west_texture

F 0,0,200
C 200,0,0

1111111111111111111111111111111111111111111
1000001000000000001000001000000000000000001
1000001000000000001000001000000000000000001
100e00000000000000000b00100100100s001001001
1000001000000000001000001000000000000000001
1000001000000000001000001000000000000000001
111111111111A111111111111001001000001001001
1000001000000000001000001000000000000000001
1000001000000000001000001000000000000000001
100000000000000000100d000000001000001001001
1000001000000000001000001000000000000000001
1000001000000000001000001000000000000000001
1111111000000000001111111111111110111111111
1000001000000000000000000000001000001000001
1000001000000000000000000000001000001000001
100000000000S00000000000000000B000000000001
1000001000000000000000000000001000001000001
1000001000000000000000000000001000001000001
1111111000000000001111111111111000001111111
10000A1000000000001000001000001000001000001
100000100000000000100w001000001000001000001
100000000000000000000w000000001000001000001
100000100000000000100w001000001000001000001
1000001000000000001000001c00001000001000001
11111111111C1D11111111111111111111111111111
1000001000000000001000001000001000001000001
1000001000000000001000001000001000001000001
1000001000000000001000001000001000001000001
1000001000000000001000001000001000001000001
1000001000000000001000001000001000001000001
1111111111111111111111111111111111111111111
1000001000001000001000001000001000001000001
1000001000001000001000001000001000001000001
1000001000001000001000001000001000001000001
1000001000001000001000001000001000001000001
1000001000001000001000001000001000001000001
1111111111111111111111111111111111111111111