NO ./assets/textures/surfaces/sludge_black.png
SO ./assets/textures/surfaces/sludge_black.png
EA ./assets/textures/surfaces/sludge_black.png
WE ./assets/textures/surfaces/sludge_black.png

F 30,30,30
C 40,40,40

1111111111111111111111111111111111111111111111111111111111111111111111111111111111111111111111111111111111111111
1000000000000000000000000000000000000100000000000000000w00000000000000000000000000000000000000000000000000000w01
100000000000000000000w000000000000000100000000000000000000000000000000000000000000000000000000000000000000000w01
10E00000000000000000000000000000000001000000000000000000000000000000000w0010000000000000000000000000000000000wG1
1000000000000000000000000000000000000000000000000000000000000000000000000010000000000000000000000000000000000w01
10000000000000000000000000000000w0000000000000000000000w00000000000000000010000000000000000000000000000000000w01
1111111111111111111111111111111111111111111111111111111111111111111111111111111111111111111111111111111111111111