NO ./assets/textures/surfaces/sludge_black.png
SO ./assets/textures/surfaces/sludge_green.png
EA ./assets/textures/surfaces/sludge_black.png
WE ./assets/textures/surfaces/sludge_black.png

F 30,30,30
C 40,40,40

1111111111111111111111111111111111111111111111111
1111111111000000000000000000000000000001111111111
111111111100000s000000a00000000000001001111111111
1111111111001000000000000000000000000001111111111
1111111111000000000000000000000000000001111111111
1111111111000000000000001000000000000001111111111
1111111111000000000000000000000000000001111111111
1111111111000000000000000000000000000101111111111
1111111111000100000000000000000000000001111111111
1111111111000000000000000000010000000001111111111
1111111111000000000010000000000000000001111111111
1000001111000000000000000000000000000001111000001
1000001111000000000000000000000w00100001111000001
10E0000000000000000000000001000000000000A0B000G01
1000001111000000100000000000000000000001111000001
1000001111000000000000000000000000000101111000001
1111111111000000000000000000000000000001111111111
111111111100000000n000000000001000000001111111111
1111111111000000000000000000000000000001111111111
1111111111010000000000000000000000000001111111111
1111111111000000000000000000000000000001111111111
1111111111000000000000000000000000010001111111111
1111111111000000010000000000000000000001111111111
1111111111000000000000000000000000000001111111111
1111111111000000000000b00000000000000001111111111
1111111111000000000000000000100000000001111111111
1111111111111111111111111111111111111111111111111