NO ./assets/textures/surfaces/sludge_black.png
SO ./assets/textures/surfaces/sludge_green.png
EA ./assets/textures/surfaces/sludge_black.png
WE ./assets/textures/surfaces/sludge_black.png

F 30,30,30
C 40,40,40

1111111111111111111111111111111111111111111
1000001000000000001000001000000000000000001
1000001000000000001000001000000000000000001
100e00000000000000000b00100100100s001001001
1000001000000000001000001000000000000000001
1000001000000000001000001000000000000000001
111111111111A111111111111001001000001001001
1000001000000000001000001000000000000000001
1000001000000000001000001000000000000000001
100000000000S00000100d000000001000001001001
1000001000000000001000001000000000000000001
1000001000000000001000001000000000000000001
1111111000000000001111111111111110111111111
1000001000000000000000000000001000000000001
1000001000000000000000000000001000000000001
100000000000000000000000000000B000000000001
1000001000000000000000000000001000001000001
1000001000000000000000000000001000001000001
1111111000000000001111111111111000001000001
10000a1000000000001000001000001000001000001
100000100000000000100w001000001000001000001
100000000000000000000w000000001000000000001
100000100000000000100w001000001000000000001
1000001000000000001000001c00001000000000001
11111111111C1D11111111111111111111111111111
1000000000000000000000001111111111111111111
1000000000000000000000001111111111111111111
1000000000000000000000001111111111111111111
1000000000000000000000001111111111111111111
1000100100000000010010001111111111111111111
1000100100000000010010001111111111111111111
1000100100000000010010001111111111111111111
10000000000nnn00000000001111111111111111111
1000000000000000000000001111111111111111111
1000000000010100000000001111111111111111111
100000000001G100000000001111111111111111111
1000000000011100000000001111111111111111111
1000000000000000000000001111111111111111111
1000000000000000000000001111111111111111111
1111111111111111111111111111111111111111111