NO ./assets/textures/surfaces/sludge_black.png
SO ./assets/textures/surfaces/sludge_green.png
EA ./assets/textures/surfaces/sludge_black.png
WE ./assets/textures/surfaces/sludge_black.png

F 30,30,30
C 40,40,40

111111111111
1S00000000G1
100000000001
100000000001
100000000001
100000100001
100001000001
100000000001
100000000001
100000000001
1G00000000G1
111111111111