NO ./assets/textures/surfaces/sludge_black.png
SO ./assets/textures/surfaces/sludge_green.png
EA ./assets/textures/surfaces/sludge_black.png
WE ./assets/textures/surfaces/sludge_black.png

F 30,30,30
C 40,40,40

1111111111111111111111111111111111111111111111111111111111111111111111111111111111111111111111
1111111111100011111111111111111111000001111111111111111111111111111111111111111111111111111111
111111111100a0011111111111111000m0000000m01111111111111111111111111111111111111111111111111111
1111111111m000m1111111111111101111000001111111111111111111111111111111111111111111111111111111
111rrl11110000011111111111111010b0000000b01111111111111111111111111111111111011111111111111111
111rllhh11000001111000000000101111000001111111111111111111111111111111111110001111111111111111
111rrl1h110000011110d0000000A010m0000000m01111111111111111111111111111111100d00111111111111111
1111111h110000011110000000001111110000011111111111111111111kkk11111111111110001111111111111111
1111111h111000111111111111111111111000111111111111111111111mmm11111111111111C11111111111111111
10000000000000000000000010000000000000000000000010000000000000000000000010000000s0s0s0s0s00111
1000000000000000000000001000000000000000000000001001001001000001001001001000000000000000000111
1000000000000000000000001000000000000000000000001000000000000000000000001000000000000000000111
1E0000000000000000000000A00000000000000000000w00B00000000000000000000000C0000000000000000G0D01
1000000000000000000000001000000000000000000000001000000000000000000000001000000000000000000101
1000000000000000000000001000000000000000000000001001001001000001001001001000000000000000000101
10000000000000000000000010000000000000000000000010000000000000000000000010000000n0n0n0n0n00101
111A11111B11111C11111D11111A11111111111111111A11111111111111A111111111111111D11111111111111101
1000001000001000001000001000001000000000001000001111111110000000111111111111000000000000000001
1000001000001000001000001000001000000000001000001111110000000000000111111111111111111111111111
100m0010m0m010mmm0100000100000A00000000000A000001111100000000000000011111111111111111111111111
1000001000001000001000001000001000000000001000001111000000000000000001111111111111111111111111
1000001000001000001000001000001000000000001000001111000000000000000001111111111111111111111111
111111111111111111111G111111111B11111111111111111111000000000000000001111111111111111111111111
1111111111111111111111111111m00000m11111111111111110000000000000000000111111111111111111111111
1111111111111111111111111111111111111111111111111110000000000000000000111111111111111111111111
1111111111111111111111111111111111111111111111111110000000000000000000111111111111111111111111
1111111111111111111111111111111111111111111111111110000000000000000000111111111111111111111111
1111111111111111111111111111111111111111111111111110000000000000000000111111111111111111111111
111111111111111111111111111111111111111111111111111e00000000000000000w111111111111111111111111
1111111111111111111111111111111111111111111111111110000000000000000000111111111111111111111111
1111111111111111111111111111111111111111111111111111e000000000000000w1111111111111111111111111
111111111111111111111111111111111111111111111111111100000000c000000001111111111111111111111111
11111111111111111111111111111111111111111111111111110e0000000000000w01111111111111111111111111
1111111111111111111111111111111111111111111111111111100n000000000n0011111111111111111111111111
111111111111111111111111111111111111111111111111111111110n0n0n0n011111111111111111111111111111
1111111111111111111111111111111111111111111111111111111111111111111111111111111111111111111111