NO ../textures/north_texture
SO ../textures/south_texture
EA ../textures/east_texture
WE ../textures/west_texture

F 0,0,200
C 200,0,0

11111111111111111111111111111111111111111111111111111
10000000000000000000100000001000000000000000000000001
10000000000000000000100000001000000000000000000000001
10000000000000000000100000001000000000000000000000001
10001111111111111000100010001000111111111111111110001
10000000000000001000000010001000100000001000000010001
10000000000000001000000010001000100000001000000010001
10000000000000001000000010001000100000001000000010001
11111111111110001111111110001000100010001000100010001
10000000000000001111111110000000100010000000100000001
10E00000000000001111111110000000100010000000100000001
10000000000000001111111110000000100010000000100000001
11111111111111111111111111111111100011111111111111111
10000000000000000000000000000001100000000000000000001
1000000000000000000000000000000G100000000000000000001
10000000000000000000000000000001100000000000000000001
10001111111111111111111111111111111111111111111110001
10001000000000000000100000001000000000000000100000001
10000000000010000000100000000000000010000000000000001
10001000000010000000000000001000000010000000100000001
11111111111111111111111111111111111111111111111111111