NO ../textures/north_texture
SO ../textures/south_texture
EA ../textures/east_texture
WE ../textures/west_texture

F 0,0,200
C 200,0,0

111111111111111111111111111111111111111111111111111111
100000000000000000000000000000000000000000000000000001
101110000000000000000000000000000000000000000000000001
100010000000000000000000000000000000000000000000000001
101110000000000000000000000000000000000000000000000001
100010000000000000000000000000000000000000000000000001
101110000000000000000000000000000000000000000000000001
10G000000000000000000000000000000000000000000000000001
100000000000000000000000000000000000000000000000000001
100000000000000000000000000000000000000000000000000001
10E000000000000000000000000000000000000000000000000001
100000000000000000000000000000000000000000000000000001
100000000000000000000000000000000000000000000000000001
100000000000000000000000000000000000000000000000000001
100000000000000000000000000000000000000000000000000001
100000000000000000000000000000000000000000000000000001
100000000000000000000000000000000000000000000000000001
100000000000000000000000000000000000000000000000000001
100000000000000000000000000000000000000000000000000001
100000000000000000000000000000000000000000000000000001
100000000000000000000000000000000000000000000000000001
111111111111111111111111111111111111111111111111111111