NO ./assets/textures/surfaces/sludge_black.png
SO ./assets/textures/surfaces/sludge_green.png
EA ./assets/textures/surfaces/sludge_black.png
WE ./assets/textures/surfaces/sludge_black.png

F 30,30,30
C 40,40,40

11111111111111111111111111111111111111111111111111111111
1000S000100000001000000011111111111111111111111111111111
10000000100000001000000011111111111111111111111111111111
100000001000a0001000n00011111111111111111111111111111111
10000000100000001000000011111111111111111111111111111111
10000000100000001000000011111111111111111111111111111111
10000000100000001000000011111111111111111111111111111111
10000000100000001000000011111111111111111111111111111111
10000000111101111111A11111111111111111111111111111111111
10000000100000000000000011111111111111111111111111111111
11000000000000000000000011111111111111111111111111111111
1A0000000000000000000000A1111111111111111111111111111111
11000000000000000000000011111111111111111111111111111111
10000000000000000000000011111111111111111111111111111111
10000000100000000000000011111111111111111111111111111111
100000001111A1111111A11111111111111111111111111111111111
10000000100000001000000011111111111111111111111111111111
10000000100000001000000011111111111111111111111111111111
10000000100000001000000011111111111111111111111111111111
10000000100000001000000011111111111111111111111111111111
10000000100000001000000011111111111111111111111111111111
1111A111111111111111111111111111111111111111111111111111
10000000111111111111111111111111111111111111111111111111
10000000111111111111111111111111111111111111111111111111
10000000111111111111111111111111111111111111111111111111
10000000111111111111111111111111111111111111111111111111
10000000111111111111111111111111111111111111111111111111
10000000111111111111111111111111111111111111111111111111
10000000111111111111111111111111111111111111111111111111
10000000111111111111111111111111111111111111111111111111
10000000111111111111111111111111111111111111111111111111
10000000111111111111111111111111111111111111111111111111
10000000111111111111111111111111111111111111111111111111
11111111111111111111111111111111111111111111111111111111