NO ./assets/textures/surfaces/sludge_black.png
SO ./assets/textures/surfaces/sludge_green.png
EA ./assets/textures/surfaces/sludge_black.png
WE ./assets/textures/surfaces/sludge_black.png

F 30,30,30
C 40,40,40

111111111111111111111111111111111111111111111111111111111111111111111
111111111111111111111111111111111111111111111111111111111111111111111
111111111000000000010000000000000000010000000000001000000000111111111
111111111000000000000000000000010000010000001000000000000000111111111
111111111000001000000000000100010000000000000001000000000100111111111
100000000000001000000100000100000000000001000001000001000000000000001
10E0000000000000000001000001000000010000010000000000010001000000000G1
100000000000000000000100000000000001000000001000000000000100000000001
111111111000000010000000000000000001000000001000010000000000111111111
111111111000000010000000010000000000000100000000010000010000111111111
111111111000100000000000000010000000000000000000000000010000111111111
111111111111111111111111111111111111111111111111111111111111111111111
111111111111111111111111111111111111111111111111111111111111111111111