NO ../textures/north_texture
SO ../textures/south_texture
EA ../textures/east_texture
WE ../textures/west_texture

F 0,0,200
C 200,0,0

111111111111111111111111111111111111111
100000000000000000000000000000000000001
100000000000000000000000000000000000001
10000000000000000000000000000a000000001
100000000000000000000000000000000000001
100000a00000000000000000000000000000001
100000000000000000000000000000000000001
100000000000000000000000000000000000001
1000000000000a0000000000000000000000001
100000000000000000000000000a0000000000111
10E00000000000000000000000000000000000AG1
10000000000000000000000000000000000000111
100000000000000000000000000000000000001
1000000000a0000000000000000000000000001
10000000000000000000000000000000a000001
100000000000000000000000000000000000001
100000000000000000000000a00000000000001
100000000000000000000000000000000000001
100000000000000000000000000000000000001
100000000000000000000000000000000000001
10000000a000000000000000000000000000001
111111111111111111111111111111111111111