NO ./assets/textures/surfaces/sludge_black.png
SO ./assets/textures/surfaces/sludge_green.png
EA ./assets/textures/surfaces/sludge_black.png
WE ./assets/textures/surfaces/sludge_black.png

F 30,30,30
C 40,40,40

111111111111111111111111111111111111111111111111111111111111
100000000000000000000000000000S00000000000000000000000000001
10a000000000000000000000000000000000000000000000000000000c01
100000000000000000000000000000000000000000000000000000000001
100000000000000000000000000000000000000000000000000000000001
100000000000000000000000000000000000000000000000000000000001
100000000000000000000000000000000000000000000000000000000001
100000000000000000000000000000000000000000000000000000000001
100000000000000000000000000000000000000000000000000000000001
100000000000000000000000000000000000000000000000000000000001
1000000000001110000000000000000000000000000000000000000000G1
100000000000000000000000000000000000000000000000000000000001
100000000000000000000000000000000000011100000000000000000001
100000000000000000000000000000000000000000000000000000000001
100000000000000000000000000000000000000000000000000000000001
100000000000000000000000000000000000000000000000000000000001
100000000000000000000000000000000000000000000000000000000001
100000000000000000000000000000000000000000000000000000000001
100000000000000000000000000000000000000000000000000000000001
10b000000000000000000000000000000000000000000000000000000d01
100000000000000000000000000000000000000000000000000000000001
111111111111111111111111111111111111111111111111111111111111
