NO ./assets/textures/surfaces/wood.png
SO ./assets/textures/surfaces/wood.png
EA ./assets/textures/surfaces/wood.png
WE ./assets/textures/surfaces/wood.png

F 30,30,30
C 40,40,40

1111111111111111111111111111111111111111111111111111
1hhhhh1hhhhh1hhhhh1hhhhhhhh1hhhhh1hhhhhhhhhhh1hhhhh1
1hhhhh1hhhhh1hhhhh1hhhhhhhh1hhhhh1hhhhhhhhhhh1hhhhh1
1hh1111hh1111111hh1hh1111hh1hh1111hh1hh1111hh1111hh1
1hh1hhhhh1hhhhhhhh1hhhhh1hh1hh1hhhhh1hh1hhhhh1hhhhh1
1hh1hhhhh1hhhhhhhh1hhhhh1hh1hh1hhhhh1hh1hhhhh1hhhhh1
1hh1hh1hh1hh1111hh1hh1hh1111hh1hh1hh1111111hh1hh1hh1
1hhhhh1hhhhhhhh1hhhhh1hhhhhhhhhhh1hhhhhhhh1hhhhh1hh1
1hhhhh1hhhhhhhh1hhhhh1hhhhhhhhhhh1hhhhhhhh1hhhhh1hh1
1111111hh1111hh1111hh1hh1111111hh1hh1111hh1111hh1hh1
1hhhhhhhh1hh1hhhhh1hh1hhhhhhhhhhh1hh1hhhhhhhhhhh1hh1
1hhhhhhhh1hh1hhhhh1hh1hhhhhhhhhhh1hh1hhhhhhhhhhh1hh1
1hh1111hh1hh1111111hh1111111hh1hh1111hh1111111hh1111
1hhhhh1hh1hhhhh1hhhhh1hhhhhhhh1hhhhhhhhhhhhhh1hhhhh1
1hhhhh1hh1hhhhh1hhhhh1hhhhhhhh1hhhhhhhhhhhhhh1hhhhh1
1111111hh1111hh1hh1hh1hh1111hh1111hh1111111hh1hh1hh1
1hhhhh1hhhhhhhhhhh1hhhhh1hhhhhhhh1hh1hh1hh1hh1hh1hh1
1hhhhh1hhhhhhhhhhh1hhhhh1hhhhhhhh1hh1hh1hh1hh1hh1hh1
1hh1hh1hh1111111hh1111hh1111111111hh1hh1hh1hh1111hh1
1hh1hhhhh1hhhhhhhh1hhhhh1hhhhh1hhhhhhhh1hhhhhhhhhhh1
1hh1hhhhh1hhhhhhhh1hhhhh1hhhhh1hhhhhhhh1hhhhhhhhhhh1
1hh1hh1hh1hh1111111hh1111hh1111hh1111111111111hh1111
1hh1hh1hhhhhhhh1hhhhhhhhhhh1hh1hhhhhhhhhhh1hhhhhhhh1
1hh1hh1hhhhhhhh1hhhhhhhhhhh1hh1hhhhhhhhhhh1hhhhhhhh1
1hh1111111111hh1hh1111111111hh1111111hh1111hh1hh1111
1hh1hhhhh1hhhhh1hh1hhhhh1GG1hhhhhhhhhhhhhhhhh1hh1hh1
1hh1hhhhh1hhhhh1hh1hhhhh1hh1hhhhhhhhhhhhhhhhh1hh1hh1
1hh1hh1111hh1111111hh1111hh1111hh1111hh1111111hh1hh1
1hhhhhhhhhhhhhhhhhhhhhhW1hhhhhhhh1hhhhhhhhhhhhhhhhh1
1hhhhhhhhhhhhhhhhhhhhhhh1hhhhhhhh1hhhhhhhhhhhhhhhhh1
1111111111111111111111111111111111111111111111111111