NO ./assets/textures/surfaces/sludge_black.png
SO ./assets/textures/surfaces/sludge_green.png
EA ./assets/textures/surfaces/sludge_black.png
WE ./assets/textures/surfaces/sludge_black.png

F 30,30,30
C 40,40,40

111111111111111111111111111111111111111111111111111111
100000000000000000000000000000000000000000000000000001
101110000000000000000000000000000000000000000000000001
10101000000000000000000000S000000000000000000000000001
101110000000000000000000000000000000000000000000000001
101010000000000000000000000000000000000000000000000001
101110000000000000000000000000000000000000000000000001
100000000000000000000000000000000000000000000000000001
100000000000000000000000000000000000000000000000000001
100000000000000000000000000000000000000000000000000001
100000000000000000000000000000000000000000000000000001
100000000000000000000000000000000000000000000000000001
100000000000000000000000000000000000000000000000000001
100000000000000000000000000000000000000000000000000001
100000000000000000000000000000000000000000000000000001
1000000000000000000000000nnn00000000000000000000000001
10000000000000000000000000n000000000000000000000000001
1000000000000000000000000nnn00000000000000000000000001
100000000000000000000000nnnnn0000000000000000000000001
100000000000000000000000000000000000000000000000000001
100000000000000000000000000000000000000000000000000001
111111111111111111111111111111111111111111111111111111