NO ./assets/textures/surfaces/sludge_black.png
SO ./assets/textures/surfaces/sludge_green.png
EA ./assets/textures/surfaces/sludge_black.png
WE ./assets/textures/surfaces/sludge_black.png

F 30,30,30
C 40,40,40

111111111111
1NhhhhhhhhG1
1hhhhhhhhhh1
1hhhhhhhhhh1
1hhhhhhhhhh1
1hhhhh1hhhh1
1hhhh1khhhh1
1hhhhhhhhhh1
1hhhhhhhhhh1
1hhhhhhhhhh1
1GhhhhhhhhG1
111111111111