NO ./assets/textures/surfaces/sludge_black.png
SO ./assets/textures/surfaces/sludge_black.png
EA ./assets/textures/surfaces/sludge_black.png
WE ./assets/textures/surfaces/sludge_black.png

F 30,30,30
C 40,40,40

111111111111111111111111111111111111111111111111111111111111111111111
100000000000000000000000000000000000000000000000000000000000000010001
100000000000000000000000000000000000000000000000000000000000000010001
100000000000000000000000000000000000000000000000000000000000000010001
100010001000100010001000100010001000100010001111111111111111100011111
100000000000000000000000000000000000000000000000o000h0000000100000001
100000000000000000000000000000000000000000000000o000h0000000100000001
100000000000000000000000000000000000000000000000o000h0000000100000001
100010001000100010001000111111111000111111111111100010001111111110001
10000000000000000000000010000000100000000000o000h00010001000000000001
10000000000000000000000010000000100000000000o000h00010001000000000001
10000000000000000000000010000000100000000000o000h00010001000000000001
1000100010001000100010001000100011111111111111A1111110001000111111111
100000000000000000000000100010000000000000001000100010001000o00000001
1000000000000000000000001000100000000000000010G0100010001000o00000001
100000000000000000000000100010000000000000001000100010001000o00000001
100010001000100010001000100011111000111111111111100010001000111110001
100000000000000000000000h00000001000000000000000000010000000000010001
100000000000000000000000h00000001000000000000000000010000000000010001
100000000000000000000000h00000001000000000000000000010000000000010001
100010001000100011111111111111111000111111111111111111111111100010001
1000000000000000000000001000000010001000000000000000hhhhh000000010001
100000000000000000000000C000000010001000000000000000hwhhh000000010001
1000000000000000000000001000000010001000000000000000hhhhh000000010001
100010001000111111111111111110001000100011111111111111111111111110001
100000000000000000001000000010001000100000000000100000000000000000001
100000000000000000a01000000010001000100000000000100000000000000000001
100000000000000000001000000010001000100000000000100000000000000000001
111111111111111111111000111110001000100011111000100011111000111111111
100010000000000000000000100000001000100000001000100010000000100000001
10a010000000000000000000100000001000100000001000100010000000100000001
100010000000000000000000100000001000100000001000100010000000100000001
1000100011111111100011111000111110001111100011111000100011111hhh10001
100010000000h00010000000000000000000000000000000000010000000o00010001
100010000000h000100000000000000000N0000000000000000010000000o0a010001
100010000000h00010000000000000000000000000000000000010000000o00010001
100011111111100011111111100011111000111111111000111111111111111110001
100000000000000010001000000000001000100000001000000000000000000000001
100000000000000010001000000000001000100000001000000000000000000000001
100000000000000010001000000000001000100000001000000000000000000000001
100011111111111110001000111111111000100010001111111111111111100010001
1000100000000000100010001hhh1000000000001000h000100010000000000010001
1000100000000000100010001hdh1000000000001000h000B00010000000000010001
1000100000000000100010001hhh1000000000001000h000100010000000000010001
1000100011111000100010001hhh10001111100011111000100011111111111110001
100000001000000010000000100010001000000000001000100000000000100000001
1000000010000000100000001000100010000000000010c0100000000000100000001
100000001000000010000000100010001000000000001000100000000000100000001
111110001000111111111000100011111000100010001111111111111000100011111
1000100010000000000000001000000000001000100000000000o0000000100010001
10b0100010000000000000001000000000001000100000000000o0000000100010001
1000100010000000000000001000000000001000100000000000o0000000100010001
1ooo10001000111111111000111111111000100011111111111110001111100011111
100000001000000000001000000010000000100000000000000010000000000010001
100000001000000000001000000010000000100000000000000010000000000010001
100000001000000000001000000010000000100000000000000010000000000010001
111111111111111110001111100011111111100010001000100011111111100010001
1000hhhh1000000000001000100000000000000000000000000000000000000000001
1000hhhh1000000000001000100000000000000000000000000000000000000000001
1000hhhh1000000000001000100000000000000000000000000000000000000000001
100011111111111111111111100010001000100010001000100010001000100010001
100010000000000000000000100000000000000000000000000000000000000000001
100010000000000000000000100000000000000000000000000000000000000000001
100010000000000000000000100000000000000000000000000000000000000000001
100010001111111110001111100010001000100010001000100010001000100010001
100000001000000000000000000000000000000000000000000000000000000000001
100000001000000000000000000000000000000000000000000000000000000000001
100000001000000000000000000000000000000000000000000000000000000000001
111111111111111111111111111111111111111111111111111111111111111111111