NO ./assets/textures/surfaces/sludge_black.png
SO ./assets/textures/surfaces/sludge_green.png
EA ./assets/textures/surfaces/sludge_black.png
WE ./assets/textures/surfaces/sludge_black.png

F 30,30,30
C 40,40,40

111111111111111111111111111111111111111111111111111111111111111111111111111111111111
11111111111000010000001000000100000000111111110000000000000000000000w000011111111111
11111111111000001000000001000001000100111111110000000s000000000000000000011111111111
111111111110000000010000000100000000101111111100000000000000w00000000000011111111111
111111111110000000100100100010000100001111111100000000000000000000000000011111111111
11100000000000010000000100000000100000000000000000000000000000000000w000000000000111
111E000000000111111111111111111111110000000000001111111111111111111111100000000000G1
111000000000000100000100000000000100000000000000000000000001000000000000000000000111
111111111110000000000100000100000100001111111100000001111101011111000000011111111111
111111111110000100000100000100000000001111111100000001000001000001000000011111111111
111111111110000100000000000100000100001111111100000001011111111101000000011111111111
111111111110000100000100000100000100001111111100000001000000000001000000011111111111
111111111111111111111111111111111111111111111111111111111111111111111111111111111111