NO ./assets/textures/surfaces/sludge_black.png
SO ./assets/textures/surfaces/sludge_green.png
EA ./assets/textures/surfaces/sludge_black.png
WE ./assets/textures/surfaces/sludge_black.png

F 30,30,30
C 40,40,40

1111111111111111111111111111111111111111111111111111
1000000000000100000100000100000100000100000000000011
1000000000000000a00A00b00A00b00B00d00C00000000000011
1000000000000100000100000100000100000100000000000011
1000000000000111111111111111111111111100000000000011
1000000000000100000100000100000100000100000000000011
1000000000000000d00A00b00A00c00B00c00D00000000000011
1000000000000100000100000100000100000100000000000011
1000000000000111111111111111111111111100000000000011
1000000000000100000100000100000100000100000000000011
1E00000000000000b00A00b00A00d00B00c00C000000000000G1
1000000000000100000100000100000100000100000000000011
1000000000000111111111111111111111111100000000000011
1000000000000100000100000100000100000100000000000011
1000000000000000a00A00d00A00c00A00b00D00000000000011
1000000000000100000100000100000100000100000000000011
1000000000000111111111111111111111111100000000000011
1000000000000100000100000100000100000100000000000011
1000000000000000c00A00b00B00c00A00d00C00000000000011
1000000000000100000100000100000100000100000000000011
1111111111111111111111111111111111111111111111111111